111111111111111111111111
11010001000C0010C0001001
101100000000100000C00C01
10010C0001C0001000000011
1000C0000000CC0010010101
101000001000000010010001
100000110C00C00000000001
10100100000000000100C001
10000100000000EC0000C011
1000001000C0011000000001
1C0000000000001000C00P01
111111111111111111111111