11111111111111111111111111111111
1000M00C00M0000C00M000C000000M01
10111001000100010000111001110001
10100101100100101000010000100001
10111001010101111100010000100001
1P1001010C11C100010101000010M001
101110010001010M0101110001110001
100M000C00M00000000M000000000M01
10011111111100000C00011111111001
100001000000100M0000100000100001
10000011111111011101111111000001
1000000C00M000001000000000000001
10010000000C00M0000000M000001001
1000100C00M00000000C00M000010001
10000111111111111111111111100001
10C00000000000000000M0E000000001
11111111111111111111111111111111