1111111111111
1M0100M0000C1
1000000000001
1P0011E000001
1111111111111