1111111111
1C0P1C1CC1
1EC0100111
1CCC001011
1111111111