1111111111
1CC110P101
10C0C0C111
1C1010ECC1
1111111111