1111111111111111111111111111111
1001000000000100000001000000101
1010001C00000110000C0000C1C0001
1C0000C00000C000C000C0000000001
100001000010100100100000C000011
1000000000C00111000000000101001
110100000000000C0C000000C010C01
100100C000000100C00C000001100C1
10010000000C000000000P101000011
101000000000000000010C0000C0001
1000000000000000000C00E0001C001
100000100000000000100010C000001
1010C0010000000000C0000000C1001
10000CC00000C0CC000100010001001
10C000001000000101000C000000001
100011C0000100C100C00000CC00001
1111111111111111111111111111111